work=Работать
pause=Пауза
you have now logged out. thank you=Вы вышли из системы. Спасибо
You have been paused for too long, you have been logged out of your session=Вы слишком долго были в состоянии пауза, вы будете отключены. 
refresh campaing list=Обновить список кампаний
title=Должность
first=Имя
mi=mi
last=Фамилия
address1=Адрес 1
address2=Адрес 2
address3=Адрес 3
city=Город
state=Штат
province=Область
postcode=Почт. индекс
vendor id=Код п.
gender=Пол
phone=Телефон
dialcode=Префикс
alt. phone=Доп. телефон
show=Показать
email=Почта
comments=Заметки
version=Версия
browser=Браузер
build=Сборка
user login error=Ошибка авторизации
phone login error=Ошибка данных телефона
agent web client=Веб клиент
re-login=Повторный вход
phone login=Номер телефона
phone password=Пароль телефона
user login=Логин
user password=Пароль
campaign=Кампания
submit=Ввод
campaign login=Вход в кампанию
login=Логин
you must log in to the timeclock first=СНАЧАЛА НУЖНО ОТМЕТИТЬСЯ В ТАБЕЛЬНЫХ ЧАСАХ
there are no shifts enabled for your user group=для Вашей группы нет разрешенных смен
error=Ошибка
you are not allowed to log in outside of your shift=Вам не разрешено входить в систему вне своей смены
manager override=УКАЗАТЬ ДРУГОГО НАЧАЛЬНИКА
manager login=Начальник Имя
manager password=Начальник Пароль
leads left to call in hopper=номера для обзвона в буфере
campaign not active, please try again=Кампания не активна, пожалуйста попробуйте снова.
login incorrect, please try again=Имя неверно, попробуйте еще раз, пожалуйста
too many login attempts, try again in 15 minutes=Слишком много попыток, попробуйте снова через 15 минут
mute=Выкл. микрофон
unmute=Вкл. микрофон
alert is off=Уведомления Вкл.
alert is on=Уведомления Выкл.
sorry, your phone login and password are not active in this system, please try again=Извините, Ваш телефон и его пароль не активировны в системе, попробуйте еще раз, пожалуйста
sorry, you are not allowed to login to this campaign=Извенить, у вас нет доступа в эту кампанию
system delay, please try again=Система задержки, пожалуйста, попробуйте еще раз
dial next=Набрать следующего
preview the lead then=Предпросмотр сведений о номере
waiting for ring...=Ожидание звонка...
no more leads in the hopper for campaign=В буфере больше нет номеров для кампании
this phone number is in the dnc list=Этот номер телефона в DNC списке
this phone number is not in the campaign lists=Этого телефонного номера нет в списках кампании
this phone number is outside of the local call time=Этот телефон находится вне местного времени вызова
unspecified error=Неизвестная ошибка
web form=Веб форма
web form 2=Веб форма 2
previous callback=Предпросмотр обратного вызова
last cal=Последний вызов
callback=Обратный вызов
agent=Агент
lead was not reverted, there was an error=Номер не был возвращен из-за ошибки
lead skipped, go on to next lead=Lead skipped, go on to next lead
alt dial number=ДОПОЛНИТЕЛЬНЫЙ НОМЕР
alt=заместитель
phone code and number=Код набора и номер:
active=Активный
notes=Примечания
alt count=Доп. счетчик:
call was not placed, there was an error=вызов не был произведен из-за ошибки
calling=Вызываю
incoming=Входящие
call disposition=КОД ЗАВЕРШЕНИЯ ВЫЗОВА
disposition status list hidden=Скрытый список кодов завершения звонка
you must be paused to enter a pause code in auto-dial mode=В РЕЖИМЕ АВТОДОЗВОНА ДЛЯ ВВОДА КОДА ПАУЗЫ НУЖНО БЫТЬ В СОСТОЯНИИ ПАУЗЫ
pause code=Код паузы
go back=Вернуться
you must be paused to search for a lead=Для поиска клиента, вы должны быть в состоянии ПАУЗА
you must be on an active inbound call to search for a lead=Для поиска клиента, вы должны быть в состоянии ПАУЗА
close [x]=Закрыть [X]
dial in-group=Вызов в группу
you must select a disposition=Вы должны выбрать код завершения
hangup again=Повторное завершение вызова
next call pause= Пауза после следующего вызова
group alias=Псевдоним группы
groups not selected=Не выбранные групп
selected groups=Выбранные группы
---add-all---=Добавить всё
manager has selected groups for you=Начальник назначил Вам входящие группы
---delete-all---=Удалить всё
territories not selected=Не выбранные территории
selected territorie=Выбранные территории
please click the logout link to log out next time=PLEASE CLICK THE LOGOUT LINK TO LOG OUT NEXT TIME
still a live call! hang it up then you can log out=ВЫЗОВ ВСЕ ЕЩЕ АКТИВЕН! Завершите его, а потом выходите из системы
you are in alt dial mode, you must finish the lead before logging out=Вы находитесь в режиме набора ALT, вы должны закончить свинца до выхода из
you cannot log out during a dial attempt. wait 50 seconds for the dial to fail out if it is not answered=Нельзя выйти из системы во время дозвона. \nЕсли на звонок не отвечают, подождите 50 секунд до истечения времени дозвона
your shift is over or has changed, you have been logged out of your session=Ваша смена закончилась или изменена, Вы были выведены из своей сессии
the system has received a command to log you out, you have been logged out of your session=Система получила команду войти вы, вы вышли из вашей сесси
you must be paused to grab calls in queue=ЧТОБЫ ВЗЯТЬ ВЫЗОВ ИЗ ОЧЕРЕДИ НУЖНО БЫТЬ В СОСТОЯНИИ ПАУЗЫ
hide calls in queue=Спрятать вызовы в очереди
show calls in queu=Показать вызовы в очереди
you must be paused to view your call log=Для просотра истории, вы должны быть в состоянии ПАУЗА
next call pause set=Установлена пауза для след. звонка
you must be paused to change groups=ДЛЯ СМЕНЫ ГРУПП НУЖНО БЫТЬ В СОСТОЯНИИ ПАУЗЫ
manager=Начальник
you must be paused to change territories=YOU MUST BE PAUSED TO CHANGE TERRITORIES
you must choose a date=Вы должны выбрать дату
dial alert=Набрать уведомления
timer notification=Уведомление по таймеру
seconds=секунд
enter a pause code=Ввести код паузы
manual queue is off=Руководство Очередь Off
time on park=В ожидании
customer hung-up, 3-way call ended automatically=Клиент Хун-до, 3-полосная окончании разговора автоматически
customer 3way hangup=CUSTOMER 3WAY зависание
lead preview=Предпросмотр сведений о номере
alt phone dial=Набор дополнительных номеров
hide conference call channel information=Скрыть сведения о линии конференции
show conference call channel information=Показать сведения о линии конференции
you do not have permissions to transfer calls=ВАМ НЕ РАЗРЕШЕНО ПЕРЕВОДИТЬ ВЫЗОВЫ
click here to log in again=КЛИКНИТЕ ЗДЕСЬ ДЛЯ ПОВТОРНОГО ВХОДА В СИСТЕМУ
local time=Текущие время
session id=Номер сессии
volumeup=Увеличить громкость клиента
volumedown=Уменьшить громкость клиента
view call log=Журнал вызовов
manual dial=Ручной набор
fast dial=Быстрый набор
status=Состояние
sec=сек
group=Группа
fronter=Агент
uid=Уник. номер
lead=Клиент
list=Список
territories=Территории
work=Работать
pause=Пауза
start recording=Начать запись
stop recording=Остановить запись
send dtmf=Отправить DTMF
grab parked call=Снять с HOLD
park call=Поставить на HOLD
record file=Файл записи
record id=Номер Записи
transfer conf=Перевод вызова
hangup customer=Завершить вызов
web form 2=Веб форма 2
reset=Сброс
disposition call=Завершения вызова
pause agent dialing=Остановить работу агента
clear form=Очистить форму
web form submit=веб-страницы отправки формы
call wrapup=Передышка
seconds remaining in wrapup=секунд до окончание передышки
finish wrapup and move on=Окончить передышку и продолжить
customer time=Время клиентов
customer information=Сведения о клиенте
channel=Линия
lead search=Поиск клиента
closer inbound group selection=ВЫБОР ВХОДЯЩЕЙ ГРУППЫ
blended calling(outbound activated)=Смешанный дозвон(исходящие активированы)
u - undefined=Н - Не определено
f - female=Ж - Женский
m - male=М - Мужской
your status=Ваше состояние
calls dialing=Вызовы
select a pause code=Выбор кода паузы
pause code selection=Код Паузы
select a preset=Выбор из телеф. книги
presets selection=Телеф. Книга
select a group alias=Выбор превдонима группы
group alias selection=Выбор превдонима группы
select a dial in-group=Выбор звонка в группу
dial in-group selection=Звонок в группу
another live agent session was open using your user id. it has been disabled. click ok to continue to the agent screen=Другой агент сейчас работает с вашим уник. номером. Он будет отключен. Нажмите "ОК" для того чтобы продолжить
your session has been disabled=Ваша сессия отключена 
there is a time synchronization problem with your system, please tell your system administrator=В вашей системе есть ошибки синхронизации времени, сообщите пожалуйста своему системному администратору
skip lead=Пропустить
dial lead=Вызвать
or=или
waiting for ring=Ожидания ответа
preview call=Предпросмотр сведений о вызове
dial now=Вызвать
if you want to dial a number and have it not be added as a new lead, enter in the exact dialstring that you want to call in the dial override field below. to hangup this call you will have to open the calls in this session link at the bottom of the screen and hang it up by clicking on its channel link there=Вы хотите набрать номер, но не добавлять его в буфер, введите полный номер, который хотите вызвать, в поле ВВОД ДРУГОГО НОМЕРА ниже. Чтобы завершить этот вызов, Вам придется открыть ссылку ВЫЗОВЫ В ЭТОЙ СЕССИИ снизу на экране и завершить его кликом по ссылке на соответствующую линию
dial lead id=Dial Lead ID
this option if checked will attempt to find the phone number in the system before inserting it as a new lead=При включении этой функции перед добавлением номера в качестве нового, его наличие в системе перепроверяется
search existing leads=Искать в имеющихся номерах
digits only=только цифры
phone number=Номер телефона
this is usually a 1 in the usa-canada=В США и Канаде это обычно единица
dial code=Код набора
all new manual dial leads will go into list=all new manual dial leads will go into list
will be added to the beginning of this number=
a dial prefix of=префикс набора
enter information below for the new lead you wish to call=Введите сведения о номере, который Вы хотите вызвать
in campaign=в кампании
new manual dial lead for= НОВЫЙ РУЧНОЙ НАБОР НОМЕРА ДЛЯ
dial override=Ввод другого номера
click here to choose a group alias=Кликните для выбора псевдонима группы
note=Примечание
you must enter a phone number and dial code to use fast dial=ДЛЯ БЫСТРОГО НАБОРА НУЖНО ВВЕСТИ НОМЕР И КОД НАБОРА
click here to deactivate=Нажмите здесь, чтобы выключить
click here to activate=Нажмите здесь, чтобы включить
no-call dial=No-Call Dial
code=Код
jan=ЯНВ
feb=ФЕВ
mar=МАР
apr=АПР
may=Май
jun=ИЮН
jul=ИЮЛ
aug=АВГ
sep=СЕН
oct=ОКТ
nov=НОЯ
dec=ДЕК
when active, simply press the keyboard key for the desired disposition for this call. the call will then be hungup and dispositioned automatically=Если включено, просто нажмите клавишу выбора кода завершения. Вызов будет завершен автоматически
disposition hot keys=Клавиши кодов завершения
lead dispositioned as=Вызов завершен с кодом
your system does not have the email setting enabled=В настройках системы нет электронной почты
invalid username/password=Неправильный логин/пароль
invalid file name=Некорректное имя файла
mail sent to=Почта отправоена к
mail could not be sent=Почта не может быть отправлена
date received=Дата получения
from=От
subject=Тема
message=Сообщение
attachments=Вложения
response subject=Тема ответа
response text=Текст ответа
reply=Ответить
agent email frame=Окно почтовых сообщений клиента
id variable missing=Нет новых сообщений
refresh=Обновить
view notes=История примечаний
show calls in queue=Показать вызовы в очереди
calls in queue=Вызовы в очереди
other agents status=Состояние других агентов
available agents transfer=Перевод доступным агентам
view comment histor=Доска комментариев истории
previous callback information=Сведения о предыдущем обратном вызове
extended alt phone information=Расширенные сведения о дополнительном номере
alt phone info=Сведения о дополнительном номере
no one is in your session=Никого нет в вашей сессии
call agent again=Повторный вызов агента
customer has hung up=Клиент повесил трубку
finish and disposition call=Завершить звонок с кодом
any changes made to the customer information below at this time will not be comitted, you must change customer information before you hangup the call=Любые изменения в сведениях о клиенте, произведенные в настоящий момент не будут сохранены. Это нужно делать до завершения вызова
select a callback date=Выбрать дату обратного звонка
select a date below=Выберите дату ниже
hours=Часы
minutes=Минуты
my callback only=Обратный вызов только для меня
cb comments=Комментарий к обратному вызову
callbacks for agent=ОБРАТНЫЕ ВЫЗОВЫ АГЕНТА
to see information on one of the callbacks below, click on the info link. to call the customer back now, click on the dial link. if you click on a record below to dial it, it will be removed from the list.=Чтобы посмотреть информацию об одном из обратного вызова ниже, нажмите на ссылку INFO. Чтобы позвонить клиенту обратно сейчас, нажмите на ссылку ВЫЗОВ. Если вы нажмете на запись ниже, чтобы набрать его, то он будет удален из списка.
territory selection=ВЫБОР ТЕРРИТОРИИ
blended calling=Смешанный дозвон
agent call log= Журнал вызовов агента
search for a contact=Поиск контакта
when doing a search for a contact, wildcard or partial search terms are not allowed=при выполнении поиска контакта, шаблона или частичное условия поиска не допускается
contact search requests are all logged in the system=Просьбы связаться с поиска всех зарегистрированных в системе
office number=Номер офиса
first name=Имя
last name=Фамилия
bu name=Наименование фирмы
department=Отдел
group name=Название группы
job title=Должность
location=Расположение
submit search=Начать поиск
reset form=Восстановить форму
search results=Результаты поиска
contacts search results=Результаты поиска контакто
search for a lead=Поиск клиента
when doing a search for a lead, the phone number, lead id or=при выполнении поиска для свинца, номер телефона, или привести ID
are the best fields to use=Ведущие поисковые запросы все вошли в систему
using the other fields may be slower.lead searching does not allow for wildcard or partial search terms.=Использование других областях может быть медленным. Ведущий поиски не позволяет шаблону или частичное условия поиска.
lead search requests are all logged in the system.=Lead search requests are all logged in the system.
phone number fields=В полях Номер телефона
main phone number=Основной номер телефона
alternate phone number=Альтернативный номер телефона
address3 phone number=Адрес номера телефона
lead id=Ун. Номер. Клиента
call notes log=История заметок по звонкам
call notes list=Список заметок по звонкам
close info box=Закрыть информацыонное окно
-- select a group to send your call to --=-- Выбор группы для отправки вашего звонка --
local closer=Местное завершение
consultative=Совещательный
hangup both lines=Отключить обе линии
number to call=Номер для вызова
agents=АГЕНТЫ
dial override=НАБОР ДРУГОГО НОМЕРА
leave 3-way call=Покинуть трехсторонний вызов
dial blind transfer=Слепой трансфер
park customer dial=Сопровождаемый трансфер
dial with customer=Конференция
presets=Телеф. книга
contacts=Контакты
voivemail=Голосовая почта
hangup call=Завершить вызов
hangup xfer line=Отключить линию перевода
lead info=Сведения о клиенте
transfer - conference=Функции перевода звонка
january=Январь
february=Февраль
march=Март
april=Апрель
june=Июнь
july=Июль
august=Август
september=Сентабрь
october=Октябрь
november=Ноябрь
december=Декабрь
su=Вс
mo=Пн
tu=Вт
we=Ср
th=Чт
fr=Пт
sa=Сб
quick transfer=Быстрый перевод звонка
custom transfer=Ручной перевод звонка
maximize=Увеличить
minimize=Уменьшить
last call=Последний вызов
Manual Queue=Manual Queue
Placing call to=Placing call to
LIVE CALLS IN YOUR SESSION=Активные звонки в вашей сессии
REMOTE CHANNEL=Линия
VOLUME=Громкость
HANGUP=Отключить
MicroPhone=Микрофон
HOT KEYS INACTIVE=Горячие клавиши Выкл.
HOT KEYS ACTIVE=Горячие клавиши Вкл.
Dial Alt Phone Number=Вызов альтернативных номеров
FINISH LEAD=Завершить 
ADDRESS3=Адресс 3
ALT PHONE=Альтерн. телеф.
MAIN PHONE=Основной телеф.
Dial Next Call=Набрать следующего
Dial Next number=Набор следующего номера
Agent Alert=Внимание
